
40 13

0000000000000000000000000000000000000000
0324655555555555555555555555555555555550
0664666666666666666666666666666666666660
0667777777777777777777777777777777777760
0666666666666666666666666666666666666760
0666666666666666666666666666666666666760
0677777777777777777777777777777777777760
0676666666666666666666666666666666666660
0676666666666666666666666666666666666660
0677777777777777777777777777777777777760
0666666666666666666666666666666666666760
0111111111111111111111111111111111111110
0955555555555555555555555555555555555550
0000000000000000000000000000000000000000