

000000000000000000000000000000
031222211111112111122222211190
011122211111441444111111111150
011111212111444444111111111110
011221115111117411166666666660
011122111111111111112111111110
011112222111111111112121111110
011111122111111111112121111110
011111111111111112211121111110
066666666666666111111166666660
011112111111111121111111111110
015111111122211121111111111110
011111111111111121111111111110
011444411111111111447411121110
011474411111111111454411111110
011441111111111111111111111110
011441111211111111111111111110
011111111111111111111111111110
011111111111111111111111111110
011111116666666666666666666660
012111111111111111122111111110
011111111111111111111111112110
011111121111111211144111111110
011111111111122111174111111110
011511111112111111111111115110
011111111111112111111111111110
011111147111111111111211111110
011111144111115111111111111110
011111111111111111111111111110
000000000000000000000000000000
