
40 20

00000000000000000000000000000000000000000
01111111117444411111111222111122222222220
01147122114545412211212221111111111111110
01144221114444411222212211111666666666660
01122211115474511122212214441111111111110
01121111117555411111111114441111111111220
01111111114444411111121114741111111222220
06666666666666666666621111111111122222220
02222111122222222211111111111112222221110
01222111111111111111111111111222222211110
01212111122222222211111111122222221111110
01212111144444444411111111222211111111110
01111111177777777711111111111111111111190
04444446666666666666611111166666666666660
04747476144444444412611111162222222222220
01151116244443444422611444461511555151110
01151116211111111122611474411511515151110
01555516211111111111111111111551555155110
01155116222222222222611111111111111111110
00000000000000000000000000000000000000000