20 30

00000000000000000000
01111111111122222210
02221111111111151210
01122211211111111210
01111114241111121110
01151114441111111110
01111114741111111110
01122216666666666660
01121114441111122110
01222114741121122210
01222116661121112220
01222114441121111220
01111114541121111110
01111114441121111110
05111111111111112210
06666666666666622110
03411222211111225410
04441222222122114710
01451111122111111110
01111111911111111110
02116111112111111110
02116112222111111110
02156122222666666660
02166111111111111440
01161112211111111740
01166111222211111110
01116111111122221110
04416111111111111110
04756111111111111150
00000000000000000000