0000000000000000000000000000000
0222221122241262212122222222220
0222221122244261441111111111220
0122211112254161457666666661110
0111111112211161111611111111110
0123211112266666666614411111110
0211121111111111111114511111110
0222221111111111111111111111110
0666666666666666666666666661110
0222222222222221112222222221110
0222222222222221141111111111110
0222222222222221141111111111110
0222222222222221141222222221110
0222222222222221441111111111110
0222222222222221571666666666660
0111111111111111111621442222220
0111111111111111111614441111110
0111166666666666666615711111110
0442222222112222222211111222110
0441111111111111111111111222110
0442111222222666666611112221110
0441221666666611111111112221110
0441111111111614441111122221110
0141111111121614441111222211110
0144121111221615751111222221110
0574121111211611111111122222110
0151121122211611111111112221110
0111121111111611111111111222110
0111111111111111111111111111110
0000000000000000000000000000000